shqipëria=ALB
andorra=AND
հայաստան=ARM
österreich=AUT
azərbaycan=AZE
belgië / belgique / belgien=BEL
беларусь=BLR
bosna i hercegovina / босна и херцеговина=BIH
българия=BGR
kıbrıs - κύπρος=CYP
hrvatska=HRV
danmark=DNK
eesti=EST
united kingdom=GBR
suomi / finland=FIN
france=FRA
deutschland=DEU
united states=GRC
éire / ireland=IRL
ísland=ISL
kosova / kosovo=KSV
latvija=LVA
liechtenstein=LIE
lietuva=LTU
lëtzebuerg=LUX
malta=MLT
moldova=MDA
monaco=MCO
crna gora / црна гора=MNE
nederland=NLD
polska=POL
portugal=PRT
česko=CZE
românia=ROU
san marino=SMR
србија=SRB
slovensko=SVK
slovenija=SVN
españa=ESP
sverige=SWE
schweiz/suisse/svizzera/svizra=CHE
україна=UKR
magyarország=HUN
